%%%%%%%%%%%
%   . %   %
% %%%.%   %
% ooooo   %
% %%%oo%% %
%Poooooo. %
%%%%%%%%%%%